  1  2  2  2  2  2  9  9  2  2  2  2  2  2  9  9  2  2  2  2  2  2  9  9  2  2  2  2  2  3
 10 10  0  0  0  0  0  0  0  0  0  0  0  0  0  0  0  0  0  0  0  0  0  0  0  0  0  0 10 10
 10 10  0  0  0  0  0  0  0  0  0  0  0  0  0  0  0  0  0  0  0  0  0  0  0  0  0  0 10 10
 10 10  0  0  0  0  0  0  0  0  0  0  0  0  0  0  0  0  0  0  0  0  0  0  0  0  0  0 10 10
 10 10  0  0  0  0  0  0  0  0  0  0  0  0  0  0  0  0  0  0  0  0  0  0  0  0  0  0 10 10
  1  2  2  2  2  3  0  0  1  2  2  2  2  3  0  0  1  2  2  2  2  3  0  0  1  2  2  2  2  3
 10 10  0  0  0  0  0  0  0  0  0  0  0  1  0  0  3  0  0  0  0  0  0  0  0  0  0  0 10 10
 10 10  0  0  0  0  0  0  0  0  0  0  0  1  0  0  3  0  0  0  0  0  0  0  0  0  0  0 10 10
 10 10  0  0  0  0  0  0  0  0  0  0  0  1  0  0  3  0  0  0  0  0  0  0  0  0  0  0 10 10
  1  3  0  0  0  0  0  0  0  0  0  0  0  1  0  0  3  0  0  0  0  0  0  0  0  0  0  0  1  3
  1  3  0  0  0  0  0  0  0  0  0  0  0  1  0  0  3  0  0  0  0  0  0  0  0  0  0  0  1  3
  1  3  0  0  8  0  0  0  0  8  0  0  0  1  0  0  3  0  0  0  8  0  0  0  0  8  0  0  1  3
  1  3  7  2  2  2  2  2  2  2  2  2  2  2  0  0  2  2  2  2  2  2  2  2  2  2  2  7  1  3
 10 10  0  0  0  0  0  0  0  0  0  0  0  0  0  0  0  0  0  0  0  0  0  0  0  0  0  0 10 10
 10 10  0  0  0  0  0  0  0  0  0  0  0  0  0  0  0  0  0  0  0  0  0  0  0  0  0  0 10 10
 10 10  0  0  0  0  0  0  0  0  0  0  0  0  0  0  0  0  0  0  0  0  0  0  0  0  0  0 10 10
  1  2  2  2  8  2  2  2  8  2  2  2  8  2  2  2  2  8  2  2  2  8  2  2  2  8  2  2  2  3
