 12 13  9  9  9 16 16 16 16  9  9  9  9 12 16 16 13  9  9  9 12 13
 14 15  9  9  9 17 17 17 17  9  9  9  9 14 17 17 15  9  9  9 14 15
  9  9  0  0  0  0  0  0  0  0  0  0  0  0  0  0  0  0  0  0  9  9
  9  9  0  0  0  0  0  0  0  0  0  0  0  0  0  0  0  0  0  0  9  9
  9  9  0  0  0  0  0  0  0  0  0  0  0  0  0  0  0  0  0  0  9  9
  1  3  0  0  0  0  1  2  2  2  2  2  2  2  2  3  0  0  0  0  1  3
  9  9  0  0  0  0  0  0  0  0  0  0  0  0  0  0  0  0  0  0  9  9
  9  9  0  0  0  0  0  0  0  0  0  0  0  0  0  0  0  0  0  0  9  9
  9  9  0  0  0  0  0  0  0  0  0  0  0  0  0  0  0  0  0  0  9  9
  1  2  2  2  2  2  2  2  2  3  0  0  0  0  1  3  6  6  6  6  1  3
  9  9  0  0  0  0  0  0  0  0  0  0  0  0  0  0  0  0  0  0  9  9
  9  9  0  0  0  0  0  0  0  0  0  0  0  0  0  0  0  0  0  0  9  9
  9  9  0  0  0  0  0  0  0  0  0  0  0  0  0  0  0  0  0  0  9  9
  1  3  0  0  0  0  0  0  0  0  1  2  3  7  1  2  2  2  2  2  2  3
  9  9  0  0  0  0  0  0  0  0  0  0  0  0  0  0  0  0  0  0  9  9
  9  9  0  0  0  0  0  0  0  0  0  0  0  0  0  0  0  0  0  0  9  9
  9  9  0  0  0  0  0  0  0  0  0  0  0  0  0  0  0  0  0  0  9  9
  1  3  0  0  1  2  2  2  2  3  6  6  6 12 16 16 16 13  0  0  1  3
  9  9  0  0  0  0  0  0  0  0  0  0  0  4 18 18 18  5  0  0  9  9
  9  9  0  0  0  0  0  0  0  0  0  0  0  4 18 18 18  5  0  0  9  9
  9  9  0  0  0  0  0  0  0  0  0  0  0  4 18 18 18  5  0  0  9  9
  1  3  0  0  0  0  0  0  0  0  0  0  0 14 17 17 17 15  0  0  1  3
  9  9  0  0  0  0  0  0  0  0  0  0  0  0  0  0  0  0  0  0  9  9
  9  9  0  0  0  0  0  0  0  0  0  0  0  0  0  0  0  0  0  0  9  9
  9  9  0  0  0  0  0  0  8  0  0  0  0  0  0  0  0  0  0  0  9  9
  1  2  2  2  3  7  7  1  2  2 16 16  2  2  3  7  7  1  2  2  2  3
  9  9  0  0  0  0  0  0  0  0  4  5  0  0  0  0  0  0  0  0  9  9
  9  9  0  0  0  0  0  0  0  0  4  5  0  0  0  0  0  0  0  0  9  9
  9  9  0  0  0  0  0  0  0  0  4  5  0  0  0  0  0  0  0  0  9  9
  1  3  0  0  1  2  2  3  0  0  4  5  0  0  1  2  2  3  0  0  1  3
  9  9  0  0  0  0  0  0  0  0  4  5  0  0  0  0  0  0  0  0  9  9
  9  9  0  0  0  0  0  0  0  0  4  5  0  0  0  0  0  0  0  0  9  9
  9  9  0  0  0  8  0  0  8  0  4  5  0  8  8  0  0  8  8  0  9  9
  1  2  2  2  2  2  2  2  2  2 17 17  2  2  2  2  2  2  2  2  2  3
