  1  2  2  2  2  2  2  2  2  2  2  2  2  2  2  2  2  2  2  2  2  2  2  2  2  2  2  2  2  3
  1  2  2  2  2  2  2  2  9  9  9  2  2  2  2  2  2  2  9  9  9  2  2  2  2  2  2  2  2  3
 10 10  0  0  0  0  0  0  0  0  0  0  0  0  6  0  0  0  0  0  0  0  0  0  0  0  0  0 10 10
 10 10  0  0  0  0  0  0  0  0  0  0  0  0  6  0  0  0  0  0  0  0  0  0  0  0  0  0 10 10
 10 10  0  0  0  0  0  0  0  0  0  0  0  0  6  0  0  0  0  0  0  0  0  0  0  0  0  0 10 10
 10 10  0  0  0  0  0  0  0  0  0  0  0  0  6  0  0  0  0  0  0  0  0  0  0  0  0  0 10 10
  1  2  2  2  7  2  2  2  2  2  2  2  2  2  2  2  2  2  2  2  2  2  2  2  2  7  2  2  2  3
 10 10  0  0  0  0  0  0  0  0  0  0  0  0  6  0  0  0  0  0  0  0  0  0  0  0  0  0 10 10
 10 10  0  0  0  0  0  0  0  0  0  0  0  0  6  0  0  0  0  0  0  0  0  0  0  0  0  0 10 10
 10 10  0  0  0  0  0  0  0  0  0  0  0  0  6  0  0  0  0  0  0  0  0  0  0  0  0  0 10 10
  1  2  2  2  2  2  2  2  3  0  0  0  0  0  6  0  0  0  0  0  1  2  2  2  2  2  2  2  2  3
 10 10  0  0  0  0  0  0  0  0  0  0  0  0  6  0  0  0  0  0  0  0  0  0  0  0  0  0 10 10
 10 10  0  0  0  0  0  0  0  0  0  1  2  2  2  2  2  3  0  0  0  0  0  0  0  0  0  0 10 10
 10 10  0  0  0  0  0  0  0  0  0  0  0  0  0  0  0  2  0  0  0  0  0  0  0  0  0  0 10 10
 10 10  0  0  0  0  0  0  0  0  0  0  0  0  0  0  0  2  0  0  0  0  0  0  0  0  0  0 10 10
  1  2  2  2  8  2  2  2  8  2  2  2  8  2  2  2  8  2  2  2  8  2  2  8  2  2  8  2  2  3
  1  2  2  2  2  2  2  2  2  2  2  2  2  2  2  2  2  2  2  2  2  2  2  2  2  2  2  2  2  3
