  1  2  2  9  9  2  2  2  2  9  9  9  9  9  2  2  2  9  9  9  2  3
  9  9  0  0  0  0  0  0  0  0  0  0  0  0  0  0  0  0  0  0  9  9
  9  9  0  0  0  0  0  0  0  0  0  0  0  0  0  0  0  0  0  0  9  9
  9  9  0  0  0  0  0  0  0  0  0  0  0  0  0  0  0  0  0  0  9  9
  9  9  0  0  0  0  0  0  0  0  0  0  0  0  0  0  0  0  0  0  9  9
  1  3  0  0  6  0  0  0  0  0  0  0  0  0  1  2  2  2  3  0  1  3
  9  9  0  0  0  0  0  0  0  0  0  0  0  0  0  0  0  0  0  0  9  9
  9  9  0  0  0  0  0  0  0  0  0  0  0  0  0  0  0  0  0  0  9  9
  9  9  0  0  0  0  0  0  0  0  0  0  0  0  0  0  0  0  0  0  9  9
 12 13  0  0  0  0  0  0  0  0  0  0  0  0  0  0  0  0  0  0 12 13
 14 15  0  1  2  2  2  3  0  0  0  0  0  0  0  0  0  0  0  0 14 15
  9  9  0  0  0  0  0  0  0  0  0  6  6  0  0  0  0  0  0  0  9  9
  9  9  0  0  0  0  0  0  0  0  0  0  0  0  0  0  0  0  0  0  9  9
 12 13  0  0  0  0  0  0  0  0  0  0  0  0  0  0  0  0  0  0 12 13
  4  5  0  0  0  0  0  0  0  0  0  0  0  0  0  0  0  0  0  0  4  5
  4  5  0  0  0  0  0  0  0  0  0  0  0  0  0  0  0  0  0  0  4  5
  4  5  0  0  0  0  0  0  0  0  0  0  0  0  0  0  0  0  0  0  4  5
 14 15  0  0 12 16  2  2  2  2  2  2  2  2  2  2  2  2  2  7 17 15
  9  9  0  0  4  5  0  0  0  0  0  0  0  0  0  0  0  0  0  0  9  9
  9  9  0  0 14 15  0  0  0  0  0  0  0  0  0  0  0  0  0  0  9  9
  9  9  0  0  0  0  0  0  0  0  0  0  0  0  0  0  0  0  0  0  9  9
  9  9  0  0  0  0  0  0  0  0  0  0  0  0  0  0  0  0  0  0  9  9
 12 13  0  0  0  0  0  0  0  0  0  0  0  0  0  0  0  0  0  0 12 13
 14 15  0  0  0  0  0  1  2  2  2  3  0  0  0  0  6  0  6  0 14 15
 10 10  0  0  0  0  0  0  0  0  0  0  0  0  0  0  0  0  0  0 10 10
 10 10  0  0  0  0  0  0  0  0  0  0  0  0  0  0  0  0  0  0 10 10
 10 10  0  0  0  0  0  0  0  0  0  0  0  0  0  0  0  0  0  0 10 10
  1  3  0  1  2  3  0  0  0  0  0  0  0  0  0  0  0  0  0  0  1  3
 10 10  0  0  0  0  0  0  0  0  0  0  0  1  2  2  3  0  0  0 10 10
 10 10  0  0  0  0  0  0  0  0  0  0  0  0  0  0  0  0  0  0 10 10
 10 10  0  0  0  0  0  0  0  0  0  0  0  0  0  0  0  0  0  0 10 10
 12 13  0  0  0  0  0  0  0  0  0  0  0  0  0  0  0  0  0  0 12 13
  4  5  0  8  0  0  0  8  0  0  8  0  0  0  8  0  0  8  0  0  4  5
 14 17  2  2  2  2  2  2  2  2  2  2  2  2  2  2  2  2  2  2 17 15
