 12 16 16 16 16 16 16 16 16 16 16 16 16 16 16 16 16 16 16 16 16 13
  4 18 17 17 17 18 18 18 18 18 18 18 18 18 18 18 18 18 18 18 18  5
 14 15  9  9  9 14 17 17 17 17 17 17 17 17 17 17 17 17 17 17 17 15
  9  9  0  0  0  0  0  0  0  0  0  0  0  0  0  0  0  0  0  0  9  9
  9  9  0  0  0  0  6  6  6  6  6  6  6  6  0  0  0  0  0  0  9  9
  9  9  0  0  0  6  0  0  0  0  0  0  0  0  0  0  6  6  0  0  9  9
  9  9  6  6  6  0  0  0  0  0  0  0  0  0  0  0  6  6  0  0  9  9
  1  2  2  2  2 16 16  2  2  2  2  2  2  3  7  1  2  3  7  1  2  3
  9  9  0  0  0 14 15  0  0  0  0  0  0  0  0  6  6  0  0  0  9  9
  9  9  0  0  0  6  6  0  0  0  0  0  0  0  0  0  0  0  0  0  9  9
  9  9  0  0  0  0  0  0  0  0  0  0  0  0  0  0  0  0  6  6  9  9
  1  3  0  0  0  0  0  0  0  0  0  0  0  0  0  1  3  0  0  6  1  3
  9  9  0  0  0  0  1  2  3  0  0  0  0  0  0  0  0  0  0  0  9  9
  9  9  0  0  0  0  0  0  0  0  0  0  0  0  0  0  0  0  0  0  9  9
  9  9  0  0  0  0  0  0  0  0 12 16  2  2 16 13  0  0  0  0  9  9
  1  2  2  3  0  0  0 12 16  2 17 15  9  9 14 15  7  1  2  2  2  3
  9  9  0  0  0  0  0  4  5  0  0  0  0  0  0  0  0  0  0  6  9  9
  9  9  0  0  0  0  0 14 15  0  0  0  0  0  0  0  0  0  0  0  9  9
  9  9  0  0  0  0  0  0  0  0  0  0  0  0  0  0  0  0  0  0  9  9
  9  9  8  0  0  0  0  0  0  0  8  0  0  0  0  0  0  0  0  0  9  9
  1  2  2  2  2  2  3  7  1  2  3  7  1  2  2  6  6  1  2  2  2  3
  9  9  0  0  0  0  0  0  0  6  0  0  0  0  0  0  0  0  0  0  9  9
  9  9  0  0  0  1  2  3  0  0  0  0  0  0  0  0  0  0  0  0  9  9
  9  9  0  0  0  0  0  0  0  0  0  0  0  0  0  0  0  1  3  0  9  9
  9  9  0  0  0  0  0  0  0  1  2  3  0  0  0  0  0  0  0  0  9  9
 12 16 13  0  0  0  0  8  0  0  0  0  0  0  0  0  0  0  0 12 16 13
 14 17 15  0  0  1  2  2  3  0  0  0 12 16  2  2  3  0  6 14 17 15
  9  9  0  0  0  0  0  6  0  0  0  0  4  5  0  0  0  0  0  6  9  9
  9  9  0  0  0  0  0  0  0  0  0  0  4  5  0  0  0  0  0  0  9  9
  9  9  0  0  0  0  0  0  0  0  0  0  4  5  0  0  0  0  0  0  9  9
 12 13  0  0  0  8  0  0  8  0  0  0  4  5  0  8  8  0  0  0 12 13
  4 18 16 16 16 16 16 16 16 16 16 16 18 18 16 16 16 16 16 16 18  5
  4 18 18 18 18 18 18 18 18 18 18 18 18 18 18 18 18 18 18 18 18  5
 14 17 17 17 17 17 17 17 17 17 17 17 17 17 17 17 17 17 17 17 17 15
